##########################################################################################
#                                                                                        #
#                                                                                        #
#                                                                                        #
#                                                                                        #
#                                                                                        #
#                                                                                        #
#                                                                                        #
#                                        LEVEL 1                                         #
#                                                                                        #
#                                                                                        #
#                                                                                        #
#                                                                                        #
#                                                                                        #
#                                                                                        #
#                                                                                        #
#                                                                                        #
#                                                                                        #
##########################################################################################
#                                                                                        #
#                                       UI HERE                                          #
#                                                                                        #
##########################################################################################